RH Lv 1
6
0 3 2 1 1 0
1 0 1 2 0 1
2 1 2 1 1 0
3 0 2 1 1 0
3 3 1 3 0 1
5 1 1 3 0 1

RH Lv 2
6
0 3 2 1 1 0
1 0 1 2 0 1
2 1 2 1 1 0
2 0 2 1 1 0
3 2 1 3 0 1
4 0 1 3 0 1

RH Lv 3
6
0 3 2 1 1 0
1 0 1 2 0 1
2 1 2 1 1 0
4 1 1 2 0 1
5 0 1 3 0 1
3 3 1 3 0 1

AR Lv 1
10
1 1 2 2 1 1
0 0 1 1 1 1
1 0 1 1 1 1
2 0 1 1 1 1
3 0 1 1 1 1
0 1 1 2 1 1
3 1 1 2 1 1
0 3 2 1 1 1
2 3 2 1 1 1
1 4 2 1 1 1

AR Lv 2
10
1 2 2 2 1 1
0 0 1 1 1 1
3 0 1 1 1 1
0 1 1 1 1 1
3 1 1 1 1 1
0 2 1 2 1 1
3 2 1 2 1 1
1 1 2 1 1 1
0 4 2 1 1 1
2 4 2 1 1 1

AR Lv 3
10
1 2 2 2 1 1
1 1 1 1 1 1
0 3 1 1 1 1
2 4 1 1 1 1
3 2 1 1 1 1
0 1 1 2 1 1
3 3 1 2 1 1
1 0 2 1 1 1
2 1 2 1 1 1
0 4 2 1 1 1