4 5
10
1 1 2 2 1 1
0 0 1 1 1 1
1 0 1 1 1 1
2 0 1 1 1 1
3 0 1 1 1 1
0 1 1 2 1 1
3 1 1 2 1 1
0 3 2 1 1 1
2 3 2 1 1 1
1 4 2 1 1 1
