6 6
6
0 3 2 1 1 0
1 0 1 2 0 1
2 1 2 1 1 0
2 0 2 1 1 0
3 2 1 3 0 1
4 0 1 3 0 1
